11111111111111111111
10000000000000000001
10000000000000000001
10000000000000000001
10001000011000000001
10000000011000000001
10000000000000000001
10000000000000000001
10000000000000000001
10000000000000000001
10000000001000000101
10000000011100000101
10000011111111001111
11111111111111111111
11111111111111111111
